position,team,played,wins,loss,draws,for,against,diff,points
1,Hamilton Azzurri JSC,9,9,0,0,30,6,24,27
2,Cooks Hill UFC,9,7,1,1,29,11,18,22
3,Westlakes Wildcats FC,9,3,4,2,18,15,3,11
4,Maryland Fletcher FC,8,3,3,2,13,16,-3,11
5,Garden Suburb SC,9,2,3,4,16,23,-7,10
6,Wallsend FC,8,3,5,0,17,18,-1,9
7,New Lambton FC,8,2,3,3,12,16,-4,9
8,Uni Men's FC,9,3,6,0,17,25,-8,9
9,Jesmond FC,9,2,6,1,20,31,-11,7
10,Stockton JSC,8,1,4,3,16,27,-11,6
